1f00

1f00

1f00

1f00

1f00

1f00

1f00

1f00

1f00

1f00

100000e1010001e10900

100000e1020000e10900

100001e1010000e10900

100000e1020000e10900

100000e1010001e10900

100000e1020000e10900

100001e1010000e10900

100000e1020000e10900

100000e1010001e10900

100000e1020000e10900

050001e3080001e1010000e10900

030006e102000ae1050000e1

04e1040004e1080007e1

