e3e3e3e3e3e3e3e3e3e3e3e3e3e3e3e3e3e3e3e3e3e3e3e3e3e3e3e3e3e3e3e3
e3656600000000000000000000000000000000000000000000000000000000e3
e3858600000000000000000000000000000000000000000000000000000405e3
e3a5a600000000000000000000000000000000000000000000000000002425e3
e1e1e1e1e1e1c1c2e1e100000000000000000000000000e1e1c1c2e1e1e1e1e1
e30000000000c1c20000000000000000000000000000000000c1c200000000e3
e30000000000c1c20000e1e1e1e1e100000000e1e1e1e10000c1c200000000e3
e30000000000c1c2000000000000e100000405e10000000000c1c200000000e3
e30000000000c1c2000000000000e100002425e10000000000c1c200000000e3
e38182000000c1c2000000000000e1e1e1e1e1e10000000000c1c200000000e3
e3a1a2000000c1c20000000000000000000000000000000000c1c200000000e3
e1e1e1e1e1e1e1e1e1e100000000000000000000000000e1e1e1e1e1e1e1e1e1
e3000000000000000000000000000000000000000000000000000000000000e3
e3040500000000000000000000000000000000000000000000000000000000e3
e3242500000000000000000000000000000000000000000000000000000000e3
e3e1e1e1e1e1e1e1e1e1e1e1e1e1e1e1e1e1e1e1e1e1e1e1e1e1e1e1e1e1e1e1
