e3e365660000000000000000000000000000000000000000000000008182e3e3
e3e38586000000000000000000000000000000000000000000000000a1a2e3e3
e3e3a5a60000000000000000000000000000000000000000c1c2e1e1e1e1e3e3
e3e3e1e1e1e1e1e1c1c20000000000000000000000000000c1c204050000e3e3
e3e3000000000000c1c20000000000000000000000000000c1c224250000e3e3
e3e3000000000000e1e1e1e1e1e1e100000000e1e1e1e1e1e1e1e1000000e3e3
e3e300000000000000000000000000000000000000000000000000000000e3e3
e3e300000000000000000000000000000000000000000000000000000000e3e3
e3e304050000000000000000000000000000000000000000000000000000e3e3
e3e324250000000000000000000000000000000000000000000000000000e3e3
e3e3e1e1e1e1e10000000000e1e1e1e1c1c2e1e1e1e1000000e1e1e1e1e1e3e3
e3e30000000000000000000000000000c1c2000000000000000000000000e3e3
e3e30000000000000000000000000000c1c2000000000000000000000000e3e3
e3e30000000000000000000000000000c1c2000000000000000000000405e3e3
e3e30000000000000000000000000000c1c2000000000000000000002425e3e3
e3e3e3e3e3e3e3e3e3e3e3e3e3e3e3e3e3e3e3e3e3e3e3e3e3e3e3e3e3e3e3e3
