0000000000000000000000000000000000000000000000000000000000000000
6566000000000000000000000000000000000000000000000000000000000000
8586000000000000000000000000000000000000000000000000000004050000
a5a6000000000000000000000000000000000000000000000000000024250000
e1e1e1e1e1e1e1c1c2e1e1e100000000000000000000000000e1e1e1e1e10000
00000000000000c1c200000000000000000000000000000000e1000000000000
04050000000000c1c200000000000000000000000000e1e1e1e1000000000405
24250000000000c1c200000000000000000000000000e1000000000000002425
e1e2e2e2e2e2e2e2e200000000000000e1e1e1e1e1e1e100000000c1c2e2e2e2
e1000000000000000000000000000000e100000000000000000000c1c20000e1
e100000000000000000000c1c2e1e1e1e100000000000000000000c1c20000e1
0000000000000000000000c1c2000000000000a9aae2e2e2e2e2e2e2e20000e1
0000000000000000000000c1c2000000000000c9cae2000000000000000000e1
0000000000e2e2e2e2e2e2e2e2e2e200000000e9eae2818200000000000000e1
000000000000000000000000000000000000000000e2a1a200000000000000e1
e1e1e1e1e1e1e1e1e1e1e1e1e1e1e1e1e1e1e1e1e1e1e1e1e1e1e1e1e1e1e1e1
