e2e2e2e2e2e2e2e2e2e2e2e2e2e2e2e2e2e2e2e2e2e2e2e2e2e2e2e2e2e2e2e2
e3e4000000000000000000000000000000000000000010300000000000000e3e3
e3e4656600000000000000000000000000000000000010300000000000000e3e3
e3e4858600000000000000000000000000000000000010300000000000000e3e3
e3e4a5a60000000000000000000000000000000500000000000000000000e3e3
e1e1e1e1e1e1e1e1e1e1c1c200000000c1c2e1e1e1e1e1e1000000c1c2e1e1e1
e3e40000000000000000c1c200000000c1c2000000000000000000c1c200e3e4
e3e40000000000000000c1c269696969c1c2000000000000000000c1c200e3e4
e3e40000000000000000c1c269262669c1c2000000000000000000c1c200e3e4
e3e40500000000000000c1c269262669c1c2000000000000000000c1c200e3e4
e2e2e2e2e2e2e2e2e2e2e2e2e2e2e2e2e2e2e2e2e2e2e2e2c1c2e2e2e2e2e2e2
e3e400000000000000000000000000000000000000000000c1c200000000e3e4
e3e400000000000000000000000000000000000000000000c1c200000000e3e4
e3e481820000000000000000000000000000000000000000c1c200000000e3e4
e3e4a1a20000000000000000000000000000000000000000c1c200000005e3e4
e1e1e1e1e1e1e1e1e1e1e1e1e1e1e1e1e1e1e1e1e1e1e1e1e1e1e1e1e1e1e1e1
