e1e1e1e1e1e1e1e1e1e1e1e1e1e1e1e1e1e1e1e1e1e1e1e1e1e1e1e1e1e1e1e1
e1e1000000000000e10000000000000000000000000000e100000000006566e1
e100000000000000e10405000000000000000000000000e100000000008586e1
e10000e1e1000000e12425000000000000000000000000e10000000000a5a6e1
e1000000e1000000e1e1e1e1e1e1e1e1e1000000000000e1000000e1e1e1e1e1
e1e10000e1000000e10000000000000000e10000000000e1000000e1040500e1
e1000000e1000000e1000000000000000000e100000000e1000000e1242500e1
e10000e1e1000000e1e1e1c1c2e100000000e1e1e1c1c2e1000000e1000000e1
e1000000e1000000000000c1c20000000000000000c1c200000000e1000000e1
e1e10000e1000000000000c1c20000000000000000c1c200008182e1000000e1
e1000000e1000000000000c1c20000000000000000c1c20000a1a2e1000000e1
e10000e1e1e1c1c2e10000e1e1e1e1e1e1e1e1e1e1e1e1c1c2e1e1e10000e1e1
e10000000000c1c2e10000000000000000000000000000c1c2000000000000e1
e10405000000c1c2e10000000000000000000000000000c1c2000000000000e1
e12425000000c1c2e10000000000000000000000000000c1c2000000000000e1
e1e1e1e1e1e1e1e1e1e1e1e1e1e1e1e1e1e1e1e1e1e1e1e1e1e1e1e1e1e1e1e1
