6566000000000000000000000000000000000000000000000000000000000000
8586000000000000000000000000000000000000000000000000000000000000
a5a6000000000000000000000000000000000000000000000000000000000005
e1e1e1e1e1e1e1e1e1e1c1c2e1e1e1e1e1e1e1e1e1e1e1e1e1e1e1e1e1e1e1e2
00000000000000000000c1c20000000000000000000000000000000000000000
00000000000000000000c1c20000000000000000000000000000000000000000
00000000000000000000c1c20000000000000000000000000000000000000000
00000000000000000000c1c20000000000000000000000000000000000008182
05000000000000000000c1c2000000000000000000000000000000000000a1a2
e2e2e2e2e2e2c1c2e2e2e2e2e2e2e2e2e2e2e2e2e2c1c2e2e2e2e2e2e2e2e2e2
000000000000c1c200000000000000000000000000c1c2000000000000000000
000000000000c1c200000000000000000000000000c1c2000000000000000000
000000000000c1c200000000696969690000000000c1c2000000000000000000
000000000000c1c200000000694848690000000000c1c2000000000000000000
050000000000c1c200000000692626690000000000c1c2000000000000000000
e1e1e1e1e1e1e1e1e1e1e1e1e1e1e1e1e1e1e1e1e1e1e1e1e1e1e1e1e1e1e1e2
