0004050000000000000000000000000000000000000000000000000000008182
002425000000000000000000000000000000000000000000000000000000a1a2
00e1e1e1e1e1e100000000000000280000000000000000000000e1e1e1e1e1e1
00000000000000000001020000000000000000000000000000000000000000e1
00000000000000000021220000000000000000000000000000000000000000e1
e10000000000000000e2e2e2e2e2e2e2e2e2c1c2e2e2e2e2e2e20000000000e1
e10000000000000000000000000000000000c1c20000000006070000000000e1
e10000000000000000000000000000000000c1c20000000026270000000000e1
e1000000000000000000000000000000e1e1e1e10000000026270000000405e1
e1000000000000000000000000000000000000000000000026270000002425e1
e10000000000000000000000000000000000000000000000262700e2e2e2e2e1
e100000000000000000000e1e1c1c200000000000000000026270000000000e1
e1000000000000000000000000c1c200000000000000000126270000000405e1
e1000000000000000000000000c1c200000000000000002126270000002425e1
e1000000000000000000000000c1c20000000000c1c2e2e2e2e2e2e2e2e2e2e1
e10000000000e1e1e1e1000000c1c20000000000c1c2000000000000000000e1
e1040500000000000607000000c1c20000000000c1c2000000000000000000e1
e1242500000000002627000000c1c20000000000c1c2000000000000000000e1
e1e1e1e1e10000002627000000e2e2e2e2e2e2e2e2e2e20000000028000000e1
e1000000000000282627000000000000000000000000e20000000000006566e1
e1000001020000002627000000000000000000000000e10001020000008586e1
e1000021220000002627000000000000000000000000e1002122000000a5a6e1
e1e1e1e1e1e1e1e1e1e1e1e1e1e1e1e1e1e1e1e1e1e1e1e1e1e1e1e1e1e1e1e1
