e3e3e3e3e3e3e3e3e3e3e3e3e3e3e3e3e3e3e3e3e3e3e3e3e3e3e3e3e3e3e3e4
e3e3000000000000002800000000010200000000000000000000090a0000e3e4
e3e3000000000000000000000000212200000000000000000000292a0000e3e3
e3e3e1e1e1e10000e1e1e1e1e1e1e1e1e1e1e10000e1e1c1c2e1e1e1e1e1e1e1
e3e46566103000000090a00000000000000000000000000c1c20000000000e3e4
e3e48586103000000292a00000000000000000000000000c1c20000000000e3e4
e4e4a5a6103000000000000000000000000000000000000c1c20000000000e3e4
e2e2e2e2e2e2e2e2e2e2e20000e2e2e2c1c2e2e2e20000e2e2e2e2e2e2e2e2e2
e3e40000090a00000000000000000000c1c20000000010300090a00000000e3e4
e3e40000292a00000028000000000000c1c20000280010300292a00000000e3e4
e3e40000000000000000000000000000c1c20000010210300000000008182e3e4
e3e40000000000000000000000000000c1c2000021221030000000000a1a2e3e4
e1e1e1e1e1e1e1e1e1e1e1e10000e1e1c1c2e1e1e1e1e1e10000e1c1c2e1e1e1
e3e40000000000090a00000000000000c1c2000000000000000000c1c200e3e4
e3e40000000000292a00000000000000c1c2000000000000000000c1c200e3e4
e3e40000000001020000000000000000c1c2000000000028000000c1c200e3e4
e3e40000000021220000000000000000c1c2000000000000000000212200e3e4
e1e2e1e1c1c2e2e2e20000e2e2e2e2e2e2e2e20000e2e2e2c1c2e2e2e2e2e2e2
e3e40000c1c20000000000000000090a0000000000000000c1c20000090ae3e4
e3e40000c1c20000280000000000292a0000000000000000c1c20000292ae3e4
e3e40000c1c2000000000000000000000001020000000000c1c200000000e3e4
e3e40000c1c2000000000000000000000021220000000000c1c200000000e3e4
e1e1e1e1e1e1e1e1e1e1e1e1e1e1e1e1e1e1e1e1e1e1e1e1e1e1e1e1e1e1e1e1
