e3e3e3e3e3e3e3e3e3e3e3e3e3e3e3e3e3e3e3e3e3e3e3e3e3e3e3e3e3e3e3e3
e3656600000000000000000028000000000000000000000000000000000000e3
e3858600000000000000000000000000000000000000000000000000000405e3
e3a5a6e1e1e1e1e1e1e1e1e1e1e1e1e1c1c2e1e1e1e1e1e1e1e1e1e1e12425e3
e3e1e1e10000090a0000000000000000c1c20000000000000000090ae1e1e1e3
e30000000000292a0000000000000000c1c20000000000000000292a000000e3
e3000000000000000000002800000000c1c200000000000000000000000000e3
e3000000000000000000000000000000c1c200040500000000000000000000e3
e3000000000000000000000000000000c1c200242500000000002800000000e3
e30102000000000000e1e1e1e1e1e1e1e1e1e1e1e1e1e1e100000000010200e3
e32122000000000000e10000000000090a000000000000e100000000212200e3
e3e1e1e1e1e1c1c2e1e10000000000292a000000000000e1e1c1c2e1e1e1e1e3
e30000090a00c1c20000000000000000000000000000000000c1c200000000e3
e30000292a00c1c20000000000e1e100000000e1e100000000c1c200000000e3
e30000000000c1c2000000000000e101020405e10000000000c1c200000000e3
e30000000000c1c2000000000000e121222425e10000280000c1c200000000e3
e38182000000c1c2000000000000e1e1e1e1e1e10000000000c1c200000000e3
e3a1a2000000c1c20000000000000000000000000000000000c1c200000000e3
e3e1e1e1e1e1e1e1e1e100000000000000000000000000e1e1e1e1e1e1e1e1e3
e3000000000000000000002800000000000000000000000000000000000000e3
e3040500000000000000000000000000000000000000000000000000010200e3
e3242500000000000000000000000000000000000000000000000000212200e3
e3e1e1e1e1e1e1e1e1e1e1e1e1e1e1e1e1e1e1e1e1e1e1e1e1e1e1e1e1e1e1e1
