e3e3e3e3e3e3e3e3e3e3e3e3e3e3e3e3e3e3e3e3e3e3e3e3e3e3e3e3e3e3e3e3
e3e300000000000000000000040500000000000000000000000000000000e3e3
e3e300000000000000000000242500000000000000000000000000000000e3e3
e3e365660000000000000000e2e2e100000000e2e2000000000000000000e3e3
e3e3858600000000000000e2e20607000000000607e2e200000000818200e3e3
e3e3a5a6000000000000e2e200262700000000262700e2e2000000a1a200e3e3
e3e300e2e2e2e2e2c1c2e2000026270000000026270000e2e2c1c2e2e200e3e3
e3e3000000000000c1c2000000262700000000262700000000c1c2000000e3e3
e3e3000000000000c1c2000000262700000000262700000000c1c2000000e3e3
e3e3000000000000e2e2000000262700000000262700000000e2e2000000e3e3
e3e30000000000e2e2e2e200002627000000002627000000e20000e20000e3e3
e3e300000000e2e20000e2e20026270000000026270000e2e20000e2e200e3e3
e3e300000000e200000000e2e1e1e1e1000000e1e1e1e1e2e20405e2e200e3e3
e3e300000000e2e20000e2e2000000000000000000000000e22425e20000e3e3
e3e30000000000e2e2e2e20000000000000000000000000000e2e2000000e3e3
e3e3040500000000e2e2000000e100000000000102e10000000000000000e3e3
e3e32425000000000000000000e100000000002122e10000000000000000e3e3
e3e3e1e1e1e1e1010200000000e1e1e1c1c2e1e1e1e100000000e1e1e1e1e3e3
e3e300000000e1212200000000000000c1c20000000000000000e1000000e3e3
e3e300000000e1e1e1e1e10000000000c1c20000000000e1e1e1e1000000e3e3
e3e30000000000000000000000000000c1c2000000000000000000000405e3e3
e3e30000000000000000000000000000c1c2000000000000000000002425e3e3
e3e3e3e3e3e3e3e3e3e3e3e3e3e3e3e3e3e3e3e3e3e3e3e3e3e3e3e3e3e3e3e3
