e1e1e1e1e1e1e1e1e1e1e1e1e1e1e1e1e1e1e1e1e1e1e1e1e1e1e1e1e1e1e1e1
e16566e1000000000000000000000000000000000000000000000000e10000e1
e18586e1000000000000000000000000000000000000000000000102e10000e1
e1a5a6e1000000000000000000000000000000000000000000002122e10000e1
e100e1e1040500000000000000000000000004050000e1e1e1e1e1e1e18182e1
e10000e1242500000000000000000000000024250000000000000000e1a1a2e1
e10000e1e1e10000000000000000e1e1c1c2e1e10000000000000000e1e100e1
e10000e1000000000000000000000000c1c200000000000000000000e10000e1
e10000e1000000000000000000000000c1c200000000000000000405e10000e1
e1e100e10000e1e1e1c1c2e1e1000000c1c200000000000000002425e10000e1
e10000e10000000000c1c20000000000c1c200000000000000e1e1e1e10000e1
e10000e10000000000c1c20000000000c1c200000000000000000000e10000e1
e10000e10000000000c1c20000000000c1c200000000000000000000e100e1e1
e10000e10000000000c1c20000000000c1c200000000000000000000e10000e1
e100e1e1e1e1000000c1c20000000000c1c200000102000000e1e1e1e10000e1
e10000e10000000000c1c20000000000c1c200002122000000000000e10000e1
e10405e10000000000e1e1e1e1e1e1e1e1e1e1e1e1e1e1e100000000e10000e1
e12425e1010200000000000000000000000000000000000000000000e10000e1
e1e100e1212200000000000000000000000000000000000000000000e1e100e1
e10000e1e1e1e1e100000000000000000000000000000000e1e1e1e1e10000e1
e1000000000000000000000000000000000000000000000000000000000000e1
e1000000000000000000000000000000000000000000000000000000000000e1
e1e1e1e1e1e1e1e1e1e1e1e1e1e1e1e1e1e1e1e1e1e1e1e1e1e1e1e1e1e1e1e1
