e1e1e1e1e1e1e1e1e1e1e1e1e1e1e1e1e1e1e1e1e1e1e1e1e1e1e1e1e1e1e1e1
e1656600000000000000000000000000000000000000000000000000000000e1
e1858600000000000000000000000000000000000000000000000000000000e1
e1a5a600000000000000000000000000000000000000000000000000000000e1
e1e1e1e1e1e1e10000e1e1e1e1e1e1e1e1e1e1e1c1c2e1e1e1e1e1e1000000e1
e1000000e1000000000000000000000000000000c1c20000000000e1000000e1
e1000000e1000000000000000000000000000000c1c20000000000e1000000e1
e1000000e1000000000000000000000000000000c1c20000000000e1000000e1
e1e10000e1000000e1e1e10000e1c1c2e1e1e1e1e1e1e1e1000000e1000000e1
e1000000e1000000e10000000000c1c200000000000000e1000000e1000000e1
e10000e1e1000000e10000000000c1c200000000000000e1000000e1000000e1
e1000000e1000000e1e1e1e1e1e1e1e1e1000000000000e1000000e1000000e1
e1e10000e1000000e10000000000000000e10000000000e1000000e1000000e1
e1000000e1000000e1000000000000000000e100000000e1000000e1000000e1
e10000e1e1000000e1e1e1c1c2e100000000e1e1e1c1c2e1000000e1000000e1
e1000000e1000000000000c1c20000000000000000c1c200000000e1000000e1
e1e10000e1000000000000c1c20000000000000000c1c200008182e1000000e1
e1000000e1000000000000c1c20000000000000000c1c20000a1a2e1000000e1
e10000e1e1e1c1c2e10000e1e1e1e1e1e1e1e1e1e1e1e1c1c2e1e1e1000000e1
e10000000000c1c2000000000000000000000000000000c1c2000000000000e1
e1e100000000c1c2000000000000000000000000000000c1c2000000000000e1
e10000000000c1c2000000000000000000000000000000c1c2000000000000e1
e1e1e1e1e1e1e1e1e1e1e1e1e1e1e1e1e1e1e1e1e1e1e1e1e1e1e1e1e1e1e1e1
