e1e1e1e1e1e1e1e1e1e1e1e1e1e1e1e1e1e1e1e1e1e1e1e1e1e1e1e1e1e1e1e1
000000000000000000000000000000000000000000000000000000090a0000e1
040500000000000000002800000000000102000000000000000000292a0000e1
24250000000000000000000000000000212200000000000000000000000000e1
e1e1e1e1000000e1e1e1e10000c1c2e1e1e1e1e1e10000e1e1e1e100000405e1
00000000000000000000000000c1c200000000000000000000000000002425e1
00000000000000280000000000c1c2000000000000000000000000e1e1e1e1e1
00000000000000000000000000c1c20000000000000000000000e1e100000000
000000e1e1e1e1e1e1e1e1e1e1e1e1e1e1e1e1e1e1e1c1c2e1e1e10000000000
0102000000000000000000000000090a000000000000c1c20000000000000000
2122000000000000000000000000292a000000000000c1c20000000000000000
e1e1e1e1e1e1e1c1c2e1e1e100000000000000000000c1c200e1e1e1e1e10000
00000000000000c1c200000000000000000000000000c1c200e1000000000000
04050000000000c1c200000000000000000028000000e1e1e1e1000000000405
24250000000000c1c200000000000000000000000000e1000000000000002425
e1e2e2e2e2e2e2e2e200000000000000e1e1e1e1e1e1e100000000c1c2e2e2e2
e10000090a0000000000000000000000e100090a00000000000000c1c20000e1
e10000292a000000000000c1c2e1e1e1e100292a00000000000000c1c20000e1
0000000000002800000000c1c2000000000000a9aae2e2e2e2e2e2e2e20000e1
0000000000000000000000c1c2000000000000c9cae2000000000000000000e1
0001020000e2e2e2e2e2e2e2e2e2e200000000e9eae2818200000000000000e1
002122000000000000000000000000000000000000e2a1a200000000000000e1
e1e1e1e1e1e1e1e1e1e1e1e1e1e1e1e1e1e1e1e1e1e1e1e1e1e1e1e1e1e1e1e1
