00000006070000090a0000000000000000000607000000000000000000000000
00000026270000292a0000000000000000002627000028000000000000006566
0000002627040500000000000000000004052627000000000102000000008586
000000262724250000000000000000002425262700000000212200000000a5a6
e1e1e2e2e2c1c2e2e2e2e2e2e2e2e2e2e2e2e2e2c1c2e2e2e2e2e2e2e2e2e2e2
0000000000c1c20607000000090a000000000000c1c200000607000000000000
0000000000c1c22627000000292a000000000000c1c200002627000000000000
0000000000c1c226270000000000000028000000c1c200002627000000000000
0004050000c1c226270000000000000000000000c1c200002627000000000405
0024250000c1c226270000000000000000000000c1c200002627000000002425
e1e1e1e1e1e1e1e1e1e1c1c2e1e1e1e1e1e1e1e1e1e1e1e1e1e1e1e1e1e1e1e2
00000000060700000000c1c200000000000006070000090a0000000000000000
00000000262700000000c1c200000028000026270000292a0000000000000000
00000000262700000000c1c20000000000002627000000000000000000000000
00040500262700000000c1c20000000000002627000000000000000102000000
00242500262700000000c1c20000000000002627000000000000002122000000
e1e1e1e1e1e1c1c2e1e1e1e1e1e1e1e1e1e1e2e1e1c1c2e1e1e1e1e2e1e1e1e2
000000000000c1c2000000000006070000090a0000c1c2000000000607000000
000028000000c1c2000000000026270000292a0000c1c2000000282627000000
000000000000c1c200000000002627000000000000c1c2000000002627000000
000000000000c1c200000001022627000000000000c1c2000000002627000405
000000000000c1c200000021222627000000000000c1c2000000002627002425
e1e1e1e1e1e1e1e1e1e1e1e1e1e1e1e1e1e1e1e1e1e1e1e1e1e1e1e1e1e1e1e2
0000000000000000000000000000000000000000000000000000000000000000
0000000000000000000000000000000000000000000000000000000000000000
0000000000000000000000000000000000000000000000000000000000000000
