e1e1e1e1e1e1e1e1e1e1e1e1e1e1e1e1e1e1e1e1e1e1e1e1e1e1e1e1e1e1e1e1
e1000000000000000000000000000000000000000000000000000405000000e1
e10000000000e1e1e1c1c2e1e1000000000000000000000000002425000000e1
e10000e10000000000c1c20000000000000000000000000000e1e1e1e10000e1
e10000e10000000000c1c20000000000000000000000000000000000e10000e1
e10000e10000000000c1c20000000000000000000000000000000000e100e1e1
e10000e10000000000c1c20000000000000000000000000000000000e10000e1
e100e1e1e1e1000000c1c20000000000000000000000000000e1e1e1e10000e1
e10000e10000000000c1c20000000000000000000000000000000000e10000e1
e10405e10000000000e1e1e1e1e1e1e1e1e1e1e1e1e1e1e100000000e10000e1
e12425e1000000000000000000000000000000000000000000000000e10000e1
e1e100e1000000000000000000000000000000000000000000000000e1e100e1
e16566e1e1e1e1e100000000000000000000000000000000e1e1e1e1e10000e1
e18586e1000000000000000000000000000000000000000000000405e18182e1
e1a5a6e1000000000000000000000000000000000000000000002425e1a1a2e1
e1e1e1e1e1e1e1e1e1e1e1e1e1e1e1e1e1e1e1e1e1e1e1e1e1e1e1e1e1e1e1e1
