e3e3e3e3e3e3e3e3e3e3e3e3e3e3e3e3e3e3e3e3e3e3e3e3e3e3e3e3e3e3e3e4
e3e400000000000000000000000000000000000000000000000000000000e3e4
e3e400000000000000000000000000000000000000000000280000000102e3e4
e3e400000028000000000000000000000000000000000000000000002122e3e4
e3e4000000000000000000006566c1c2e1e1e1e1e1e1e1e1e1e1e1e1e1e1e3e4
e3e4010200000000000000008586c1c20000000000000000000000000000e3e4
e3e421220000000000000000a5a6c1c20000000000000000000000000000e3e4
e3e4e1e1c1c2e1e1e1e1e1e1e1e1e1e1c1c2000000000028000000000000e3e4
e3e40000c1c200000000000000000405c1c2000000000000000000000102e3e4
e3e40000c1c200002800000000002425c1c2000000000000000000002122e3e4
e3e40000c1c20000000000000000e1e1e1e1e1e1e1e1e1e1e1e1e1e1e1e1e3e4
e3e40102c1c2000000000000000000000000000000000000000000000000e3e4
e3e42122c1c2000000000000000000000000000000000000000000000000e3e4
e3e4e1e1e1e1e1e1e1e1e1e1e1e100000000000000000000000000000000e3e4
e3e400000000000000000000000000000000000000000000002800000102e3e4
e3e400000000000000000000000000000000000000000000000000002122e3e4
e3e400000000000028000000000000e1c1c2e1e1e1e1e1e1e1e1e1e1e1e1e3e4
e3e40102000405000000000000000000c1c2000000000000000000000000e3e4
e3e42122002425000000000000000000c1c2000000000000000000000000e3e4
e3e4e1e1e1e1e1e1e1e1e1e1e1000000c1c2000000000000000000000000e3e4
e3e48182000000000000000000000000c1c2000000000000000000000405e3e4
e3e4a1a2000000000000000000000000c1c2000000000000000000002425e3e4
e4e4e4e4e4e4e4e4e4e4e4e4e4e4e4e4e4e4e4e4e4e4e4e4e4e4e4e4e4e3e3e4
