e3e3e3e3e3e3e3e3e3e3e3e3e3e3e3e3e3e3e3e3e3e3e3e3e3e3e3e3e3e3e3e3
e3000000000000000000000000000000000000000000000000000000006566e3
e3040500000000000000000000000000000000000000000000000000008586e3
e32425000000000000000102000000000000000000000000000000e1e1a5a6e1
e3e1e1c1c2000000000021220000000000000000000000000000000000e2e2e3
e30000c1c20000000000e1e1e1e1e1e1e1e1e1c1c2e1e10000000000000000e3
e30000c1c20000000000000000000000000000c1c200000000000000000000e3
e30000c1c20000000000000000008182000000c1c200000000000000000000e3
e30000c1c2000000000000000000a1a2000000c1c200000000000000000000e3
e30000c1c200000000000000e1e1e1e1000000e1e1e1000000000000000000e3
e30000c1c200000000000000c1c200000000000000e1e10000000000000000e3
e30000c1c200000000000000c1c20000000000000000000000000000000000e3
e30000c1c200000000000000c1c20000000000000000000000000000000000e3
e30000e1e1e1e1e1e1000000c1c200000000000000000000e1e1e1e1000000e3
e30000000000000000000000c1c20000000000000102000000000000000000e3
e30000000000000000000000c1c20000000000002122000000000000000000e3
e300010200000000000000e1e1e1e1e1e1e1e1e1e1e1e10000000000000405e3
e3002122000000000000000000000000000000000000000000000000002425e3
e3e1e1e1e1e10000000000000000000000000000000000000000e1e1e1e1e1e3
e300000000e10000000000000000000000000000000000000000e100000000e3
e304050000e10000000000000000000000000000000000000000e100000000e3
e3242500000000000000000000000000000000000000000000000000000000e3
e3e3e3e3e3e3e3e3e3e3e3e3e3e3e3e3e3e3e3e3e3e3e3e3e3e3e3e3e3e3e3e3
